1111111111111111111111111111111111
1010000111000000C00000000000000001
1001010100100000101001000000010101
1010010011101010001001000000010101
1P000000000000000000000000E0000001
1111111111111111111111111111111111
