1111111111111111111111111111111111
1010000111000001C10000000000000001
1001010100100001011001000000010101
1100010011101011011001000010010101
1P000000000000000000000000E1000001
1111111111111111111111111111111111
